11111111111111111111111
10001000000000000010001
10101011111411111010101
10000000100000100000001
11101010101110101010111
10000010101310101000001
10101010101110101010101
14001010000000001010041
11111010111111101011111
10000010000000001000001
10111110111211101111101
100000401gg3gg104000001
10111110111111101111101
10000010000400001000001
11111010111111101011111
10001010000000001010001
10101010101110101010101
10000010101310101000001
11101010101110101010111
10000000100p00100000001
10101011111011111010101
10001000000000000010001
11111111111111111111111

0 ball
1 wall
2 gate          (only one)
p pacman        (only one)
g ghost         (only four)
3 blank
4 power ball
